##########
#        #
#        #
#   X    #
#        #
#        #
##########
