#######################
#     #   #           #
#     #   #  #   #    #
#   #   # #  #   #   ##
# ###   # #  #   ##   #
# #  #### ####   #  # #
# #  #  #        #    #
# #     #  ####      ##
# #  #  #  ####  #    #
#    #  #  ####  #    #
######  #        #  ###
#X   #  #   ######   OE
###  #  #       ##    #
# #  #  #   ##   # #  #                          
# #     #    #   #    #
# ####  ###   #     # #
#         #      # ## #
#  ###  ###   ####  # #
#  #      # # # #     #
#  #      #   # #   # #
#  ### ####       ### #
#    #       ####   # #
#       #    #####  # #
#######################
